███████████
█Sokoban█☻█
█████████.█
█.......█.█
█.........█
█.█.۩█●.█.█
█....█..█.█
███████████
█МИНИРАУНД█
███████████
