████████████████████
█Sokoban█.......█..█
█████████.█.●..█.●.█
█.......█.....█....█
█.██......███████..█
█..███.............█
█.█..█...●.....█████
█....█......●......█
█...████..☻.....██.█
█..█...........███.█
█.██......██.█..██.█
█.█....█...█.......█
█.█...██.████..█████
█.█................█
█.███.........████.█
█...██...۩...█████.█
███..██.....██████.█
█..█..██...███████.█
█......██..........█
██████FGH███████████
