████████████████████
█Sokoban█.......█..█
█████████.█....█...█
█.......█.....█....█
█.██......███████..█
█..................█
█.█..☻...●.....█████
█......●....●......█
█.....●۩●.......██.█
█......●.......███.█
█.██......██.█..██.█
█.█....█...█.......█
█.█...██.████..█████
█.█................█
█.███.........████.█
█...██.......█████.█
███..██..●..██████.█
█..█..██...███████.█
█......██..........█
██████FGH███████████
