████████████████████
█Sokoban█.......█..█
█████████.█....█...█
█.......█.....█....█
█.██......███████..█
█..███.............█
█.█..█.........█████
█....█.............█
█...████........██.█
█..█...........███.█
█.██......██.█..██.█
█.█....█...█.......█
█.█...██.████..█████
█.█................█
█.███.........████.█
█...██.☻●۩...█████.█
███..██.....██████.█
█..█..██...███████.█
█......██..........█
██████FGH███████████
